6,6,6,8,11,11,11,11,11,11,11,11,11,11,9
6,8,11,12,3,3,3,3,3,3,3,3,3,3,5
6,7,3,3,3,3,3,3,3,3,3,3,3,3,5
6,7,3,3,3,3,3,3,3,3,3,3,0,1,14
6,7,3,3,3,3,3,3,3,3,3,3,10,9,6
6,7,3,3,3,3,3,3,3,3,3,3,3,10,9
8,12,3,3,3,3,3,3,3,3,3,3,3,3,5
7,3,3,3,3,3,3,3,3,3,3,3,3,3,5
7,3,3,3,3,3,3,3,3,3,3,3,3,3,5
7,3,3,3,3,3,3,3,3,3,3,3,3,3,5
12,3,3,3,3,3,3,3,3,3,3,3,3,3,5
3,3,3,3,3,3,3,3,3,3,3,3,3,0,14
3,3,3,3,3,3,3,3,3,3,3,3,0,14,6
3,3,3,3,0,1,1,1,1,1,1,1,14,6,6
3,3,3,3,3,5,6,6,6,6,6,6,6,6,6
